1 1 1 1 1 1 1 1 1 1 1 1 1 1 1 1 
1 0 0 1 1 0 0 2 0 0 0 0 3 0 0 1 
1 0 0 1 1 0 0 0 0 0 1 1 0 0 1 1 
1 0 0 1 0 3 0 1 0 0 0 1 3 1 0 1 
1 1 1 1 0 1 0 0 3 0 3 0 0 0 0 1 
1 0 0 1 3 0 0 3 0 1 1 1 1 1 1 1 
1 0 1 1 0 0 0 1 1 1 0 0 0 0 0 1 
1 1 0 1 0 0 1 1 0 0 0 0 0 1 1 1 
1 0 0 0 0 0 0 1 0 0 0 1 0 0 0 1 
1 0 1 1 1 1 1 1 0 3 0 0 0 1 1 1 
1 0 0 1 0 0 0 0 0 1 1 1 0 0 0 1 
1 0 0 1 1 0 1 1 3 1 0 1 0 1 1 1 
1 0 1 0 0 0 0 1 1 0 1 1 0 0 0 1 
1 0 1 0 1 0 0 0 0 0 0 0 0 1 1 1 
1 0 0 0 1 0 0 0 3 0 0 3 0 1 0 1 
1 1 1 1 1 1 1 1 1 1 1 1 1 1 1 1 
33
2 11
2 10
2 9
2 8
2 7
2 6
3 6
4 6
4 5
4 4
3 4
2 4
2 3
2 2
3 2
4 2
5 2
6 2
7 2
8 2
8 3
8 4
8 5
8 6
9 6
10 6
10 7
11 7
12 7
13 7
14 7
14 8
15 8
